#######E########E####################
# ### #...###### #    #     #     # E
# ### ###.#      #  #    #     #    #
# ### # #.# ###### ##################
#.........   #       #    #   #   # #
#. # ##      # ##### #  # # # # # # #
#. #         #   #   #  # # # # #   #
#. ######   ###  #  ### # # # # ### #
#. #    #               #   #   #   #
#. # ## ########   ## ###########   #
#.   ##          ###                #
#.## #############  ###   ####   ## #
#. ### ##         #  #  #           #
#. #   ## ####     #    #      ###  #
#. # #### #  #     #    #####       #
#. #      #      ###           ##   #
#. #####           #   ##   #   #   #
#..................                 #
##################.##################